UFRJ	NÃO
PUCRS	NÃO
UCLA	NÃO
PUCMG	NÃO
UFRGS	NÃO
UFMG	NÃO
PUCPR	NÃO
PUCRIO	NÃO
FATERJ	(4) SIM
FACESTA	(6) SIM
CEUB	NÃO
FAZAG	(9) SIM
AVANTIS	(1) SIM
FASAR	(15) SIM
PUCGO	NÃO
MIT	NÃO
FAEX	(7) SIM
FLF	(12) SIM
ENSITEC	(13) SIM
UNIFRA	(3) SIM
EMSM	(9) SIM
UNINCOR	(6) SIM
Laboro	(0) SIM
FAMETA	(7) SIM
IFRR	(9) SIM
FCAT	(6) SIM
FAT	(6) SIM
UFPE	NÃO
SENAC	(5) SIM
FARESI	(6) SIM
SENAI	(3) SIM
FAJANSSEN	(4) SIM
UFERSA	(6) SIM
FSA	(0) SIM
OXFORD	NÃO
FAMA	(5) SIM
USP	NÃO
FMO	(19) SIM
UFMA	NÃO
FASPI	(8) SIM
