UFRJ	N�O
PUCRS	N�O
UCLA	N�O
PUCMG	N�O
UFRGS	N�O
UFMG	N�O
PUCPR	N�O
PUCRIO	N�O
FATERJ	N�O
FACESTA	N�O
CEUB	N�O
FAZAG	N�O
AVANTIS	(28) SIM
FASAR	N�O
PUCGO	N�O
MIT	N�O
FAEX	N�O
FLF	(29) SIM
ENSITEC	(13) SIM
UNIFRA	N�O
EMSM	N�O
UNINCOR	(6) SIM
Laboro	N�O
FAMETA	N�O
IFRR	N�O
FCAT	N�O
FAT	N�O
UFPE	N�O
SENAC	N�O
FARESI	N�O
SENAI	N�O
FAJANSSEN	N�O
UFERSA	N�O
FSA	N�O
OXFORD	N�O
FAMA	(5) SIM
USP	N�O
FMO	N�O
UFMA	N�O
FASPI	N�O
